14
20
3
3
1 1 2 1 2 1 2 1 1 1 1 1 1 1
1 0 0 0 0 0 0 0 0 1 0 0 0 1
2 0 0 0 0 0 0 0 0 4 0 0 0 1
1 0 0 0 0 0 0 0 0 1 0 0 0 1
1 1 2 1 2 1 2 5 0 3 3 4 3 3
7 0 0 0 0 0 0 0 0 0 0 0 0 7
7 0 0 0 0 0 0 0 0 0 0 0 0 7
7 0 0 6 0 0 6 0 0 0 7 0 0 7
7 0 0 0 0 0 0 0 0 0 0 0 0 7
7 0 0 0 0 0 0 0 0 0 0 0 0 7
7 0 0 0 0 0 0 0 0 0 0 0 0 7
7 0 0 6 0 0 6 0 0 0 6 0 0 7
7 0 0 0 0 0 0 0 0 0 0 0 0 7
7 0 0 0 0 0 0 0 0 0 0 0 0 7
7 0 0 0 0 0 0 0 0 0 0 0 0 7
7 0 0 6 0 0 6 0 0 0 6 0 0 7
7 0 0 0 0 0 0 0 0 0 0 0 0 7
7 0 0 0 0 0 0 0 0 0 0 0 0 7
7 0 0 0 0 0 0 0 0 0 0 0 0 7
7 7 7 7 7 7 7 7 7 7 7 7 7 7

